s,s,s,s,s,s,s,s,s,s,s,s,s,s,s,s,s,s,s
s,x,-,-,-,-,-,-,ar,-,-,-,-,-,-,-,-,x,s
s,-,x,-,-,-,-,-,-,-,-,-,-,-,-,-,x,-,s
s,-,-,x,-,x,x,x,x,x,x,x,x,x,-,x,-,-,s
s,-,-,-,x,x,x,x,x,x,x,x,x,x,x,-,-,-,s
s,-,-,-,-,x,x,x,x,x,x,x,x,x,-,ar,-,-,s
s,-,-,-,-,x,x,s,s,s,x,x,x,x,-,-,-,-,s
s,-,-,-,-,-,-,s,d,s,x,-,-,-,-,-,-,-,s
s,-,-,-,-,-,s,s,b,s,s,s,s,s,s,x,s,s,s
s,-,-,-,-,-,-,x,b,x,-,-,ar,-,-,-,-,-,s
s,s,s,s,s,s,s,s,s,s,s,s,s,s,s,s,s,x,s
s,-,-,-,-,-,-,-,-,ar,-,-,-,-,-,-,-,ch,s
s,-,-,-,s,s,s,s,s,s,s,s,s,s,s,s,s,s,s
